NO texture/basics/north.png
SO texture/basics/north.png
WE texture/basics/north.png
EA texture/basics/north.png

F 220,100,0
C 225,30,0

           1111111111111111111
           10S0000000000100001
           1000010000000100001
           1000010000000000001
11111111111100111111111111100111111111111
10000000000000000000000000000000000000001
10000000000000000000000000000000000000001
10000000000000000000000011111111111111001
10001010100000000000000010000000000001001
10000000000000000N00000010000000000000001
10001000100000000000000010000000000000001
10000000000000000000000010000000000001111
10001010100000000000000011111110011111111
10000000000000000000000000000000000000001
10000000000000000000000000000000000000001
10000000000000000000000010000000000000001
10000000000000000000000000000000000000001
10000000000000000000000000000000000000001
11111111111111111111111111111111111111111
