NO ./texture/basics/North.png
SO ./texture/basics/South2.png
WE ./texture/basics/West3.png
EA ./texture/basics/East.png

F 124,252,0
C 87,206,235

111111111111111111111111111111111111111111111111111111111111111111111111111111111111111
1010N0000000000000000000000000000000000000000000000000000000000000000000000000000000001
101000000000000000000000000000000000000000000000000000000000000000000000000000000000001
101000000000000000000000000000000000000000000000000000000000000000000000000000000000001
101000000000000000000000000000000000000000000000000000000000000000000000000000000000001
101000000000000000000000000000000000000000000000000000000000000000000000000000000000001
101000000000000000000000000000000000000000000000000000000000000000000000000000000000001
101000000000000000000000000000000000000000000000000000000000000000000000000000000000001
101000000000000000000000000000000000000000000000000000000000000000000000000000000000001
101000000000000000000000000000000000000000000000000000000000000000000000000000000000001
101000000000000000000000000000000000000000000000000000000000000000000000000000000000001
101000000000000000000000000000000000000000000000000000000000000000000000000000000000001
101000000000000000000000000000000000000000000000000000000000000000000000000000000000001
101000000000000000000000000000000000000000000000000000000000000000000000000000000000001
101000000000000000000000000000000000000000000000000000000000000000000000000000000000001
101000000000000000000000000000000000000000000000000000000000000000000000000000000000001
101000000000000000000000000000000000000000000000000000000000000000000000000000000000001
101000000000000000000000000000000000000000000000000000000000000000000000000000000000001
101000000000000000000000000000000000000000000000000000000000000000000000000000000000001
101000000000000000000000000000000000000000000000000000000000000000000000000000000000001
111111111111111111111111111111111111111111111111111111111111111111111111111111111111111

