NO texture/basics/north.png
SO texture/basics/north.png


                    C          225,30,0

WE texture/basics/north.png

                     F      255,100,1
       EA       texture/basics/north.png


1111111111111111111111111
1000000000110000000000001
1011000001110000000000001
100100000000000000000000111111111
111111111011000001110000000000001
100T00000011000001110111111111111
11110111111111011100000010001
111N0111111111011101010010001
11000000110101011100000010001
10000000000000001100000010001
10000000000000001101010010001
1100000111010101111101111000111
11110111 1110101 101111010001
11111111 1111111 111111111111
