NO texture
SO texture
WE texture
EA texture

F 0,0,0
C 0,0,0

1111111111111111
1000000000000001
10000000N0000001
11111111111111