NO texture/basics/North.png
SO texture/basics/North.png
EA texture/basics/North.png
WE texture/basics/North.png

F 1,1,1
C 9,9,9

111111111111111111
10000000000000001
100000000000000001
100000000000000001
100000000001000001
100000000010000001
100011111111111111111111111111111111111111111111111111111111111111111111111111111111111111111111111111111111111111111111111111
100000000000000000000000000000000000000000000000000000000000000000000000000000000000000000000000000000000000000000000000000001
100000000000000000000000000000000000000000000000000000000000000000000000000000000000000000000000000000000000000000000000000001
100000000000000000000000000000000000000000000000000000000000000000000000000000000000000000000000000000000000000000000000000001
111111110111111111111111111111111111111111111111111111111111111111111111111111111111111111111111111111111111111111111111111111
100000000000000001
100000000000000001
100000000000000001
100000000001000001
10000000001000000S1
111111111111111111


